R 1280 720
NO ./visuals/tex_bluestone.xpm
SO ./visuals/tex_eagle.xpm
WE ./visuals/tex_greystone.xpm
EA ./visuals/tex_mossy.xpm

S ./visuals/sprt_barrel.xpm
F 120,169,140
C 70,0,70


        1111111111111111111111111
        1000000000110000000000001
        1011000001110000002000001
        1001000000000000000000001
111111111011000001110000000000001
100000000011000001110111111111111
11110111111111011100000010201
11110111111111011101010012021
11000000110101011100000000001
10002000000000000000000010001
10000000000000001101010010001
1100000111010101111100110N011
11110111 1110101 101100010001
11111111 1111111 111111011111
                      101
                      101
                      101
                      10111111
            111111111110000001
            100000000000000001
            100002222222200011
            111000000000000001
            111010001111111111
            111000011
            111111111