1111111111111
1001000001
1000011111111
1P0011E000001
1111111111111