1111111111111111111111111111111111111111111111111111
11100P000000000000000000000000000C000000000000000001
11100000000000000000000000000000000000000000000000C1
1111111111111111111111111111111111111111111111111001
1111111111111111111111111111111111111111111111111001
111111000000000000C000000000000000000000000000000001
10001100000000000000000000000000000000000C0000000001
1EEE110000011111111111111111111111111111111111111111
1000110000011111111111111111111111111111111111111111
1000110000000000000000000000000000000000000000000011
10001100000000C0000000000000000000000000000000000001
1000111111111111111111111111111111111111111111100001
1C00111111111111111111111100C001111111111111111100C1
1C00111111000000000000000000000000000000000000000001
1C00111100000000000000000000000000000000C00000000011
1C00111000001111111111111111111111111111111111111111
1C0011000C011111111111111111111111111111111111111111
1C00110000011111111111111111111111111111111111111111
1C00110000011111111111111111111111111111111111111111
100011100000000000000000000000000000C000000000000111
1000111110000000000000000000000000000000000000000001
1000011111111111111111111111111111111111111110000011
1000011111111111111111111111111111111111111111100001
1000000000000000000000000000000000000000000000000001
100000000000000000000000000000000000C000000000001111
1111111111111111111111111111111111111111111111111111